<#######**###################**########>
#**************************************#
#*!**A*0**0*A*0**0*0**0*c*0**0*0**0****#
##################################*****#
#**************************************#
#*0**0*0**0*A****B*0**0*c**A*0**0*0**0*#
#****###################################
#**************************************#
#****A*0**0*A*0**0**0**0c0**0***0**0***#
##################################*****#
#**************************************#
#*0**0*0**0*A****B*0**0*c**A*0**0*0**0*#
#****###################################
#**************************************#
#****A*0**0*A*0**0**0**0c0**0***0**0***#
##################################*****#
#**************************************#
#*0**0*0**0*A****B*0**0*c**A*0**0*0**0*#
#****###################################
#**************************************#
#****A*0**0*A*0**0**0**0c0**0***0**0***#
##################################*****#
#**************************************#
#*0**0*0**0*A****B*0**0*c**A*0**0*0**0*#
#****###################################
#**************************************#
#****A*0**0*A*0**0*0**0*c*0**0*0**0****#
##################################*****#
#*@************************************#
#*0**0*0**0*0**0**0**0*0**0*****0**0***#
########################################
