<#######**###################**########>
#**************************************#
******00****00****0000****00****00******
#*****===*====***======***====*===*****#
#**************************************#
#*****00**A*00****0000****00****00*****#
#*****========***======***========*****#
#**************************************#
#*****00****00****0000****00****00*****#
#*****========***======***========*****#
#**************************************#
#*****00****00****0000****00*B**00*****#
#*****========***======***========*****#
#**************************************#
#*****00**A*00****0000****00****00*****#
#*****========***======***========*****#
#**************************************#
#*****0******0****0***0***00****00*****#
#****************======***========*****#
#*****0******0*************************#
#*****#****A*#****0*1*0***00B***00*****#
#*****========***======***========*****#
#**************************************#
#*****0******0****0***0***00****00*****#
#*****========***======***========*****#
#**************************************#
#*****0**C***0****0*1*0***00****00*****#
#*****========***======***========*****#
#**************************************#
#*@**0******0****0*!*0***00****00******#
########**###################**#########
